{
  "header": {
    "next": {
      "top": null,
      "left": null,
      "right": "map_0_1.json",
      "bottom": "map_-1_0.json"
    },
    "edgePositions": {
      "top": 39,
      "left": -20,
      "right": -1,
      "bottom": 20
    }
  },
  "grounds": [
    ["001", "001", "001", "001", "001", "001", "001", "001", "001", "001", "001", "001", "001", "001", "001", "001", "001", "001", "001", "001"],
    ["001", "000", "000", "000", "000", "000", "000", "000", "000", "000", "000", "000", "000", "000", "000", "000", "000", "000", "000", "001"],
    ["001", "000", "000", "001", "000", "001", "000", "000", "000", "000", "000", "000", "000", "000", "000", "000", "000", "000", "000", "001"],
    ["001", "000", "001", "001", "000", "001", "000", "000", "000", "000", "000", "000", "000", "000", "000", "000", "000", "000", "000", "001"],
    ["001", "000", "000", "001", "000", "001", "000", "000", "000", "000", "000", "000", "000", "000", "000", "000", "000", "000", "000", "001"],
    ["001", "000", "000", "000", "000", "000", "000", "000", "000", "000", "000", "000", "000", "000", "000", "000", "000", "000", "000", "001"],
    ["001", "000", "000", "000", "000", "000", "000", "000", "000", "000", "000", "000", "000", "000", "000", "000", "000", "000", "000", "001"],
    ["001", "000", "000", "000", "000", "000", "000", "000", "000", "000", "000", "000", "000", "000", "000", "000", "000", "000", "000", "001"],
    ["001", "000", "000", "000", "000", "000", "000", "000", "000", "000", "000", "000", "000", "000", "000", "000", "000", "000", "000", "001"],
    ["001", "000", "000", "000", "000", "000", "000", "000", "000", "000", "000", "000", "000", "000", "000", "000", "000", "000", "000", "001"],
    ["001", "000", "000", "000", "000", "000", "000", "000", "000", "000", "000", "000", "000", "000", "000", "000", "000", "000", "000", "001"],
    ["001", "000", "000", "000", "000", "000", "000", "000", "000", "000", "000", "000", "000", "000", "000", "000", "000", "000", "000", "001"],
    ["001", "000", "000", "000", "000", "000", "000", "000", "000", "000", "000", "000", "000", "000", "000", "000", "000", "000", "000", "001"],
    ["001", "000", "000", "000", "000", "000", "000", "000", "000", "000", "000", "000", "000", "000", "000", "000", "000", "000", "000", "001"],
    ["001", "000", "000", "000", "000", "000", "000", "000", "000", "000", "000", "000", "000", "000", "000", "000", "000", "000", "000", "001"],
    ["001", "000", "000", "000", "000", "000", "000", "000", "000", "000", "000", "000", "000", "000", "000", "000", "000", "000", "000", "001"],
    ["001", "000", "000", "000", "000", "000", "000", "000", "000", "000", "000", "000", "000", "000", "000", "000", "000", "000", "000", "001"],
    ["001", "000", "000", "000", "000", "000", "000", "000", "000", "000", "000", "000", "000", "000", "000", "000", "000", "000", "000", "001"],
    ["001", "000", "000", "000", "000", "000", "000", "000", "000", "000", "000", "000", "000", "000", "000", "000", "000", "000", "000", "001"],
    ["001", "001", "001", "001", "001", "001", "001", "001", "001", "001", "001", "001", "001", "001", "001", "001", "001", "001", "001", "001"]
  ],
  "groundInfo": {
    "000": {
      "collision": false,
      "image": null,
      "color": [30, 30, 30]
    },
    "001": {
      "collision": false,
      "image": null,
      "color": [200, 200, 200]
    }
  }
}
